111111111111111
1C000000001C001
10000C000000001
110100000111001
1CP10C00E000001
111111111111111
